[
    {
        "level": [[5,1,1,1,1,1,1,1,1,1,6,5,1,1,13,1,1,1,1,6],
                  [2,0,0,0,0,0,0,0,0,0,3,2,0,0,0,0,0,0,0,3],
                  [2,0,0,0,0,0,0,0,0,0,3,2,0,0,0,0,0,0,0,3],
                  [2,0,0,0,10,9,0,0,0,0,3,2,0,0,0,0,0,0,0,3],
                  [2,0,0,0,3,2,0,0,0,0,3,2,0,0,0,0,0,0,0,3],
                  [2,0,0,0,3,2,0,0,0,0,3,7,4,4,9,0,0,0,0,3],
                  [2,0,0,0,3,2,0,0,0,0,12,1,1,1,11,0,0,0,0,3],
                  [2,0,0,0,3,2,0,0,0,0,0,0,0,0,0,0,0,0,0,3],
                  [2,0,0,0,3,2,0,0,0,0,0,0,0,0,0,0,0,0,0,3],
                  [2,0,0,0,12,11,0,0,0,0,0,0,0,0,0,0,0,0,0,3],
                  [2,0,0,0,0,0,0,0,10,4,4,4,9,0,0,0,0,0,0,3],
                  [7,4,4,4,4,4,4,4,8,14,14,14,7,4,4,4,4,4,4,8]],

    "spawn_loc": [[100, 600], [600, 600], [800, 500], [296, 104], [128, 557], [608, 359], [908, 248], [1160, 359], [497, 260]],

    "player_loc": [100, 350],

    "enemy_amount": 3,

    "key_loc": [100, 100]
  },
  {
    "level": [[5,1,1,1,1,1,1,1,1,1,1,1,1,6,14,14,14,14,14,14],
              [2,0,0,0,0,0,0,0,0,0,0,0,0,12,1,6,14,14,14,14],
              [2,0,0,0,0,10,4,4,4,9,0,0,0,0,0,3,14,14,14,14],
              [2,0,0,0,0,12,1,1,1,11,0,0,0,0,0,3,14,14,14,14],
              [2,0,0,0,0,0,0,0,0,0,0,0,0,0,0,12,1,1,1,6],
              [2,0,0,0,0,0,0,0,10,4,4,4,4,9,0,0,0,0,0,3],
              [2,0,0,0,0,0,0,0,12,1,1,1,13,11,0,0,0,0,0,3],
              [2,0,0,0,0,0,0,0,0,0,0,0,0,0,0,0,0,0,0,3],
              [2,0,0,0,10,9,0,0,0,0,0,0,0,0,10,9,0,0,0,3],
              [2,0,0,0,12,11,0,0,0,0,0,0,0,0,12,11,0,0,0,3],
              [2,0,0,0,0,0,0,0,0,0,0,0,0,0,0,0,0,0,0,3],
              [7,4,4,4,4,4,4,4,4,4,4,4,4,4,4,4,4,4,4,8]],

"spawn_loc": [[461, 357], [701, 212], [861, 164], [965, 377], [1139, 377], [1103, 602], [761, 560], [452, 545]],

"player_loc": [100, 350],

"enemy_amount": 3,

"key_loc": [578, 65]
    },
    {
      "level": [[5,1,1,1,1,1,1,1,1,1,1,1,1,1,1,1,1,1,1,6],
                [2,0,0,0,0,0,0,0,0,0,0,0,0,0,0,0,0,0,0,3],
                [2,0,0,0,10,4,4,9,0,0,0,0,10,4,4,9,0,0,0,3],
                [2,0,0,0,3,5,1,11,0,0,0,0,12,1,6,2,0,0,0,3],
                [2,0,0,0,3,2,0,0,0,0,0,0,0,0,3,2,0,0,0,3],
                [2,0,0,0,3,2,0,0,10,4,4,9,0,0,3,2,0,0,0,3],
                [2,0,0,0,3,2,0,0,12,1,13,11,0,0,3,2,0,0,0,3],
                [2,0,0,0,3,2,0,0,0,0,0,0,0,0,3,2,0,0,0,3],
                [2,0,0,0,12,11,0,0,0,0,0,0,0,0,12,11,0,0,0,3],
                [2,0,0,0,0,0,0,0,0,0,0,0,0,0,0,0,0,0,0,3],
                [2,0,0,0,0,0,0,0,0,0,0,0,0,0,0,0,0,0,0,3],
                [7,4,4,4,4,4,4,4,4,4,4,4,4,4,4,4,4,4,4,8]],

  "spawn_loc": [[830, 593], [809, 344], [630, 140], [420, 497], [96, 480], [1100, 590], [287, 608]],

  "player_loc": [100, 100],

  "enemy_amount": 3,

  "key_loc": [207, 305]
  },

  {
  "level": [[5,1,1,1,1,1,1,1,1,1,13,1,1,1,1,1,1,1,1,6],
            [2,0,0,0,0,0,0,0,0,0,0,0,0,0,0,0,0,0,0,3],
            [2,0,0,10,9,0,0,0,0,0,10,9,0,0,10,9,0,0,0,3],
            [2,0,0,12,11,0,10,9,0,0,12,11,0,0,12,11,0,0,0,3],
            [2,0,0,0,0,0,12,11,0,0,0,0,0,0,0,0,0,0,0,3],
            [2,0,0,0,0,0,0,0,0,10,9,0,0,0,0,10,9,0,0,3],
            [2,0,0,10,9,0,0,0,0,12,11,0,0,0,0,12,11,0,0,3],
            [2,0,0,12,11,0,0,0,0,0,0,0,0,0,0,0,0,0,0,3],
            [2,0,0,0,0,0,0,0,10,9,0,0,10,9,0,0,0,0,0,3],
            [2,0,0,0,0,0,0,0,12,11,0,0,12,11,0,0,0,0,0,3],
            [2,0,0,0,0,0,0,0,0,0,0,0,0,0,0,0,0,0,0,3],
            [7,4,4,4,4,4,4,4,4,4,4,4,4,4,4,4,4,4,4,8]],

  "spawn_loc": [[100, 600], [600, 600], [800, 500], [296, 104], [128, 557], [608, 359], [908, 248], [1160, 359], [497, 260]],

  "player_loc": [100, 350],

  "enemy_amount": 3,

  "key_loc": [100, 100]
  },
  {
  "level": [[5,1,1,6,5,1,1,6,5,1,1,6,5,1,1,6,5,1,13,6],
            [2,0,0,3,2,0,0,3,2,0,0,3,2,0,0,3,2,0,0,3],
            [2,0,0,3,2,0,0,3,2,0,0,3,2,0,0,3,2,0,0,3],
            [2,0,0,3,2,0,0,3,2,0,0,12,11,0,0,12,11,0,0,3],
            [2,0,0,3,2,0,0,3,2,0,0,0,0,0,0,0,0,0,0,3],
            [2,0,0,12,11,0,0,3,2,0,0,0,0,0,0,10,9,0,0,3],
            [2,0,0,0,0,0,0,3,2,0,0,10,9,0,0,3,2,0,0,3],
            [2,0,0,0,0,0,0,12,11,0,0,3,2,0,0,3,2,0,0,3],
            [2,0,0,10,9,0,0,0,0,0,0,3,2,0,0,3,2,0,0,3],
            [2,0,0,3,2,0,0,0,0,0,0,3,2,0,0,3,2,0,0,3],
            [2,0,0,3,2,0,0,10,9,0,0,3,2,0,0,3,2,0,0,3],
            [7,4,4,8,7,4,4,8,7,4,4,8,7,4,4,8,7,4,4,8]],

  "spawn_loc": [[344, 65], [394, 635], [674, 300], [878, 563], [1133, 170]],

  "player_loc": [100, 350],

  "enemy_amount": 3,

  "key_loc": [600, 70]
  }
]